# Special countries..
REB = "countries/Rebels.txt"
PIR = "countries/Pirates.txt"
NAT = "countries/Natives.txt"

# When adding a nation, always add it in the following form here:
# TAG = "countries/CountryName.txt"
# If you don't, the game might crash!!


# MU4 Modded Nations

# Formables
MOR = "countries/MoriyaShrine.txt"
SNC = "countries/ShiningNeedleCastle.txt"
TOS = "countries/OrreriesSun.txt"
MOT = "countries/Motivation.txt"
GLO = "countries/GloriousRevolution.txt"

# Revolters
CHI = "countries/ChinatsuState.txt"
SEF = "countries/SefeianState.txt"

# Starting Bookmark
SCI = "countries/Sciland.txt"
CMR = "countries/CirnoMoriya.txt"
CRF = "countries/CraftyState.txt"
ARC = "countries/Archeland.txt"
MIM = "countries/Mimalia.txt"
SER = "countries/Seerberg.txt"
FEV = "countries/Feevaton.txt"
KHA = "countries/Khaidrie.txt"
SRN = "countries/SiriusNation.txt"
BRG = "countries/BeervaAgra.txt"
INA = "countries/InabaBorderlands.txt"
ZEP = "countries/ZephianNation.txt"
BOR = "countries/Borgarberg.txt"
KOJ = "countries/KingdomOfKoisj.txt"
KKY = "countries/KoikariState.txt"
FIM = "countries/Fimland.txt"
HOS = "countries/Hooskyland.txt"
MAD = "countries/MadenicState.txt"
SCA = "countries/Scarleton.txt"
TOY = "countries/MikoRepublic.txt"
CRL = "countries/Cirlexen.txt"
USH = "countries/HarmonyStates.txt"
ALM = "countries/AlmiaRepublic.txt"
ETH = "countries/Etheria.txt"
TER = "countries/Teriton.txt"
PEB = "countries/GranPebbellia.txt"
FLR = "countries/FlandreRemilia.txt"
SPA = "countries/Spagalie.txt"
CAR = "countries/CarlEmpire.txt"
MOS = "countries/MoshennikHorde.txt"
DOT = "countries/DootDomain.txt"
